111111111111111
1000001E0100C01
1110000PC001111
1C0001110000111
111111111111111
