1111111111
1000001E01
1110000P01
1000011111
1111111111
