1111111111111111111111111
1000000000000000100100C01
1110000P00000C11100001111
1C00011000000000000000111
111000000000000C111100111
110000010001101000C000011
1110000000000000000000111
1110000000C11110000001C11
1111110000011110000001011
1000000000000000000000E11
1111111111111111111111111
