1111111
1000PC1
1000001
1111111
