1111111111111111111111111
100000000000000010M100C01
1110000P00000C11100001111
1C0001100000000C0000C0111
111000000000000C111100111
110000010001101000C000011
1110000000000000000000111
111M000000C111100CM001C11
1111110000011110000001011
1C0000000000000C000000E11
1111111111111111111111111
