1111111
1000PC1
1E00001
1111111
