111111111111111
10000000E000P11
10MC11100000011
100111111000011
1000000C0001111
111111111111111
