111111111111111111111111
1M000000000000000MM00011
110000000000000000000011
11000000P000000000000011
1100000000000000M0000011
1100000C0000000000000011
110000E00000C000M0000011
1M000000000000000M000011
111111111111111111111111
