111111111111111111111111
1MC0000C00000C000MM00011
11000C0000C00000C0000011
11C00000P000C000000C0011
11000C00000C0000M0000011
11C0000C00000000C0000011
11000CE00000C000M000C011
1MC000000C00000C0M000011
111111111111111111111111
