1111111
1000PC1
1EM0001
1111111
